%BASISPACKAGEPREFIX%WITHOUTDOTOOOBASEVERSION-%LANGUAGESTRING	Language module for %APACHEPROJECTNAME %PRODUCTVERSION, language %LANGUAGESTRING
%BASISPACKAGEPREFIX%WITHOUTDOTOOOBASEVERSION-%LANGUAGESTRING-base	Base language module for %APACHEPROJECTNAME %PRODUCTVERSION, language %LANGUAGESTRING
%BASISPACKAGEPREFIX%WITHOUTDOTOOOBASEVERSION-%LANGUAGESTRING-calc	Calc language module for %APACHEPROJECTNAME %PRODUCTVERSION, language %LANGUAGESTRING
%BASISPACKAGEPREFIX%WITHOUTDOTOOOBASEVERSION-%LANGUAGESTRING-draw	Draw language module for %APACHEPROJECTNAME %PRODUCTVERSION, language %LANGUAGESTRING
%BASISPACKAGEPREFIX%WITHOUTDOTOOOBASEVERSION-%LANGUAGESTRING-fonts	Language fonts module for %APACHEPROJECTNAME %PRODUCTVERSION, language %LANGUAGESTRING
%BASISPACKAGEPREFIX%WITHOUTDOTOOOBASEVERSION-%LANGUAGESTRING-help	Language help module for %APACHEPROJECTNAME %PRODUCTVERSION, language %LANGUAGESTRING
%BASISPACKAGEPREFIX%WITHOUTDOTOOOBASEVERSION-%LANGUAGESTRING-impress	Impress language module for %APACHEPROJECTNAME %PRODUCTVERSION, language %LANGUAGESTRING
%BASISPACKAGEPREFIX%WITHOUTDOTOOOBASEVERSION-%LANGUAGESTRING-math	Math language module for %APACHEPROJECTNAME %PRODUCTVERSION, language %LANGUAGESTRING
%BASISPACKAGEPREFIX%WITHOUTDOTOOOBASEVERSION-%LANGUAGESTRING-onlineupd	Online update language module for %APACHEPROJECTNAME %PRODUCTVERSION, language %LANGUAGESTRING
%BASISPACKAGEPREFIX%WITHOUTDOTOOOBASEVERSION-%LANGUAGESTRING-res	Language resource module for %APACHEPROJECTNAME %PRODUCTVERSION, language %LANGUAGESTRING
%BASISPACKAGEPREFIX%WITHOUTDOTOOOBASEVERSION-%LANGUAGESTRING-writer	Writer language module for %APACHEPROJECTNAME %PRODUCTVERSION, language %LANGUAGESTRING
%BASISPACKAGEPREFIX%WITHOUTDOTOOOBASEVERSION-activex	ActiveX control for %APACHEPROJECTNAME %PRODUCTVERSION
%BASISPACKAGEPREFIX%WITHOUTDOTOOOBASEVERSION-base	Base module for %APACHEPROJECTNAME%PRODUCTVERSION
%BASISPACKAGEPREFIX%WITHOUTDOTOOOBASEVERSION-calc	Calc module for %APACHEPROJECTNAME %PRODUCTVERSION
%BASISPACKAGEPREFIX%WITHOUTDOTOOOBASEVERSION-core01	Core module for %APACHEPROJECTNAME %PRODUCTVERSION
%BASISPACKAGEPREFIX%WITHOUTDOTOOOBASEVERSION-core02	Office core module for %APACHEPROJECTNAME %PRODUCTVERSION
%BASISPACKAGEPREFIX%WITHOUTDOTOOOBASEVERSION-core03	Office core module for %APACHEPROJECTNAME %PRODUCTVERSION
%BASISPACKAGEPREFIX%WITHOUTDOTOOOBASEVERSION-core04	Office core module for %APACHEPROJECTNAME %PRODUCTVERSION
%BASISPACKAGEPREFIX%WITHOUTDOTOOOBASEVERSION-core05	Office core module for %APACHEPROJECTNAME %PRODUCTVERSION
%BASISPACKAGEPREFIX%WITHOUTDOTOOOBASEVERSION-core06	Office core module for %APACHEPROJECTNAME %PRODUCTVERSION
%BASISPACKAGEPREFIX%WITHOUTDOTOOOBASEVERSION-core07	Office core module for %APACHEPROJECTNAME %PRODUCTVERSION
%BASISPACKAGEPREFIX%WITHOUTDOTOOOBASEVERSION-dict-gl	Gl dictionary for %PRODUCTNAME %PRODUCTVERSION
%BASISPACKAGEPREFIX%WITHOUTDOTOOOBASEVERSION-dict-vi	Vietnamese dictionary for %PRODUCTNAME %PRODUCTVERSION
%BASISPACKAGEPREFIX%WITHOUTDOTOOOBASEVERSION-draw	Draw module for %APACHEPROJECTNAME %PRODUCTVERSION
%BASISPACKAGEPREFIX%WITHOUTDOTOOOBASEVERSION-emailmerge	Email mailmerge module for %APACHEPROJECTNAME %PRODUCTVERSION
%BASISPACKAGEPREFIX%WITHOUTDOTOOOBASEVERSION-gnome-integratn	GNOME integration module for %APACHEPROJECTNAME %PRODUCTVERSION
%BASISPACKAGEPREFIX%WITHOUTDOTOOOBASEVERSION-graphicfilter	Graphic filter module for %APACHEPROJECTNAME %PRODUCTVERSION
%BASISPACKAGEPREFIX%WITHOUTDOTOOOBASEVERSION-headless	Headless display module for %APACHEPROJECTNAME %PRODUCTVERSION
%BASISPACKAGEPREFIX%WITHOUTDOTOOOBASEVERSION-images	Images module for %APACHEPROJECTNAME %PRODUCTVERSION
%BASISPACKAGEPREFIX%WITHOUTDOTOOOBASEVERSION-impress	Impress module for %APACHEPROJECTNAME %PRODUCTVERSION
%BASISPACKAGEPREFIX%WITHOUTDOTOOOBASEVERSION-javafilter	Java filter module for %APACHEPROJECTNAME %PRODUCTVERSION
%BASISPACKAGEPREFIX%WITHOUTDOTOOOBASEVERSION-kde-integration	KDE integration module for %APACHEPROJECTNAME %PRODUCTVERSION
%BASISPACKAGEPREFIX%WITHOUTDOTOOOBASEVERSION-math	Math module for %APACHEPROJECTNAME %PRODUCTVERSION
%BASISPACKAGEPREFIX%WITHOUTDOTOOOBASEVERSION-onlineupdate	Online update modul for %APACHEPROJECTNAME %PRODUCTVERSION
%BASISPACKAGEPREFIX%WITHOUTDOTOOOBASEVERSION-ooofonts	Fonts module for %APACHEPROJECTNAME %PRODUCTVERSION
%BASISPACKAGEPREFIX%WITHOUTDOTOOOBASEVERSION-ooolinguistic	Linguistic module for %APACHEPROJECTNAME %PRODUCTVERSION
%BASISPACKAGEPREFIX%WITHOUTDOTOOOBASEVERSION-pyuno	Pyuno module for %APACHEPROJECTNAME %PRODUCTVERSION
%BASISPACKAGEPREFIX%WITHOUTDOTOOOBASEVERSION-spellcheck	English spellchecker module for %APACHEPROJECTNAME %PRODUCTVERSION
%BASISPACKAGEPREFIX%WITHOUTDOTOOOBASEVERSION-writer	Writer module for %APACHEPROJECTNAME %PRODUCTVERSION
%BASISPACKAGEPREFIX%WITHOUTDOTOOOBASEVERSION-xsltfilter	XSLT filter samples module for %APACHEPROJECTNAME %PRODUCTVERSION
%PACKAGEPREFIX%SOLARISBRANDPACKAGENAME%BRANDPACKAGEVERSION-dict-af	Af dictionary for %PRODUCTNAME %PRODUCTVERSION
%PACKAGEPREFIX%SOLARISBRANDPACKAGENAME%BRANDPACKAGEVERSION-dict-cs	Cs dictionary for %PRODUCTNAME %PRODUCTVERSION
%PACKAGEPREFIX%SOLARISBRANDPACKAGENAME%BRANDPACKAGEVERSION-dict-da	Da dictionary for %PRODUCTNAME %PRODUCTVERSION
%PACKAGEPREFIX%SOLARISBRANDPACKAGENAME%BRANDPACKAGEVERSION-dict-de	De dictionary for %PRODUCTNAME %PRODUCTVERSION
%PACKAGEPREFIX%SOLARISBRANDPACKAGENAME%BRANDPACKAGEVERSION-dict-en	En dictionary for %PRODUCTNAME %PRODUCTVERSION
%PACKAGEPREFIX%SOLARISBRANDPACKAGENAME%BRANDPACKAGEVERSION-dict-es	Es dictionary for %PRODUCTNAME %PRODUCTVERSION
%PACKAGEPREFIX%SOLARISBRANDPACKAGENAME%BRANDPACKAGEVERSION-dict-et	Et dictionary for %PRODUCTNAME %PRODUCTVERSION
%PACKAGEPREFIX%SOLARISBRANDPACKAGENAME%BRANDPACKAGEVERSION-dict-fr	Fr dictionary for %PRODUCTNAME %PRODUCTVERSION
%PACKAGEPREFIX%SOLARISBRANDPACKAGENAME%BRANDPACKAGEVERSION-dict-hu	Hu dictionary for %PRODUCTNAME %PRODUCTVERSION
%PACKAGEPREFIX%SOLARISBRANDPACKAGENAME%BRANDPACKAGEVERSION-dict-it	It dictionary for %PRODUCTNAME %PRODUCTVERSION
%PACKAGEPREFIX%SOLARISBRANDPACKAGENAME%BRANDPACKAGEVERSION-dict-lt	Lt dictionary for %PRODUCTNAME %PRODUCTVERSION
%PACKAGEPREFIX%SOLARISBRANDPACKAGENAME%BRANDPACKAGEVERSION-dict-ne	Ne dictionary for %PRODUCTNAME %PRODUCTVERSION
%PACKAGEPREFIX%SOLARISBRANDPACKAGENAME%BRANDPACKAGEVERSION-dict-nl	Nl dictionary for %PRODUCTNAME %PRODUCTVERSION
%PACKAGEPREFIX%SOLARISBRANDPACKAGENAME%BRANDPACKAGEVERSION-dict-pl	Pl dictionary for %PRODUCTNAME %PRODUCTVERSION
%PACKAGEPREFIX%SOLARISBRANDPACKAGENAME%BRANDPACKAGEVERSION-dict-pt	Pt dictionary for %PRODUCTNAME %PRODUCTVERSION
%PACKAGEPREFIX%SOLARISBRANDPACKAGENAME%BRANDPACKAGEVERSION-dict-ru	Ru dictionary for %PRODUCTNAME %PRODUCTVERSION
%PACKAGEPREFIX%SOLARISBRANDPACKAGENAME%BRANDPACKAGEVERSION-dict-sk	Sk dictionary for %PRODUCTNAME %PRODUCTVERSION
%PACKAGEPREFIX%SOLARISBRANDPACKAGENAME%BRANDPACKAGEVERSION-dict-sl	Sl dictionary for %PRODUCTNAME %PRODUCTVERSION
%PACKAGEPREFIX%SOLARISBRANDPACKAGENAME%BRANDPACKAGEVERSION-dict-sv	Sv dictionary for %PRODUCTNAME %PRODUCTVERSION
%PACKAGEPREFIX%SOLARISBRANDPACKAGENAME%BRANDPACKAGEVERSION-dict-sw	Sw dictionary for %PRODUCTNAME %PRODUCTVERSION
%PACKAGEPREFIX%SOLARISBRANDPACKAGENAME%BRANDPACKAGEVERSION-dict-th	Th dictionary for %PRODUCTNAME %PRODUCTVERSION
%PACKAGEPREFIX%SOLARISBRANDPACKAGENAME%BRANDPACKAGEVERSION-dict-zu	Zu dictionary for %PRODUCTNAME %PRODUCTVERSION
%WITHOUTDOTUNIXPACKAGENAME%BRANDPACKAGEVERSION	Brand module for %PRODUCTNAME %PRODUCTVERSION
%WITHOUTDOTUNIXPACKAGENAME%BRANDPACKAGEVERSION-brand-%LANGUAGESTRING	Brand language module for %PRODUCTNAME %PRODUCTVERSION
%WITHOUTDOTUNIXPACKAGENAME%BRANDPACKAGEVERSION-brand-base	Base brand module for %PRODUCTNAME %PRODUCTVERSION
%WITHOUTDOTUNIXPACKAGENAME%BRANDPACKAGEVERSION-brand-calc	Calc brand module for %PRODUCTNAME %PRODUCTVERSION
%WITHOUTDOTUNIXPACKAGENAME%BRANDPACKAGEVERSION-brand-draw	Draw brand module for %PRODUCTNAME %PRODUCTVERSION
%WITHOUTDOTUNIXPACKAGENAME%BRANDPACKAGEVERSION-brand-impress	Impress brand module for %PRODUCTNAME %PRODUCTVERSION
%WITHOUTDOTUNIXPACKAGENAME%BRANDPACKAGEVERSION-brand-math	Math brand module for %PRODUCTNAME %PRODUCTVERSION
%WITHOUTDOTUNIXPACKAGENAME%BRANDPACKAGEVERSION-brand-writer	Writer brand module for %PRODUCTNAME %PRODUCTVERSION
